EA textures/wall1.xpm
NO textures/wall2.xpm
SO textures/wall3.xpm
WE textures/wall4.xpm

F 200,200,200
C 200,200,200


111111111111
100000000001
100000000001
100000000001
100000000001
100000000001
100000000001
100000000001
10000W000001
111111111111
