WE textures/wall3.xpm
EA textures/wall2.xpm
SO textures/suliman.xpm
NO textures/beko.xpm

F 154,117,45

C 135,206,235


11111111111111111111111111111111111111111111111111111111111111111111111111
100000S00000000000000000000000000000000000000000000000000000000000000000001
10000000000000000000000001111111111111111111111111111111111111111111111111111
100000000000000000000000000000000000000000000000000000000000000000000000001
10000000000000000000000001111111111111111111111111111111111111111111111111111
100000000000000000000000000000000000000000000000000000000000000000000000001
10000000000000000000000001111111111111111111111111111111111111111111111111111
100000000000000000000000000000000000000000000000000000000000000000000000001
111111111111111111111111111111111111111111111111111111111111111111111111111111111111111111111111111111
111111111111111111111111111111111111111111111111111111111111111111111111111111111111111111111111111111
10000000000000000000000001111111111111111111111111111111111111111111111111111
100000000000000000000000000000000000000000000000000000000000000000000000001
10000000000000000000000001111111111111111111111111111111111111111111111111111
100000000000000000000000000000000000000000000000000000000000000000000000001
10000000000000000000000001111111111111111111111111111111111111111111111111111
100000000000000000000000000000000000000000000000000000000000000000000000001
10000000000000000000000001111111111111111111111111111111111111111111111111111
100000000000000000000000000000000000000000000000000000000000000000000000001
10000000000000000000000001111111111111111111111111111111111111111111111111111
1111111111111111111111111

